TP53_sg1	GATGGCAAGTAATACTTCTC
KRAS_sg1	GACGGAAATGAAAACAAAAT
EGFR_sg1	GATCTAACCGAAACCATAAC
MYC_sg1	GCTGCGTTTGCAGGCTTTGT
BCL2_sg1	GCCACGACTGGCACTCGCCT
AKT1_sg1	GCCGTATTAGAAAAGTAACC
PTEN_sg1	GCAATCGGAGTTTCCGCTAC
RB1_sg1	GCTTGAAGAACGAGTCCACA
CDKN2A_sg1	GCTGAAAAATTCCTGCAGTT
PIK3CA_sg1	GGGAGTCTTCCAAGTCATGA
BRAF_sg1	GACTCGGATTCCGAGATTTA
NRAS_sg1	GTCATACCCCCTGCAGCCTC
JAK2_sg1	GTTAATGGTGGAATCCCTGA
FLT3_sg1	GTCATTTTTATATAGGCGTC
IDH1_sg1	GTATGACGGCAATATGAGCT
VHL_sg1	GATAACTGACAGTTTGGATC
NOTCH1_sg1	GGAATGTTGAGTACCAGCCT
SMAD4_sg1	GTCCACACTACTCACACTTC
APC_sg1	GGAATAGGTCTCCTTCAGAC
MLH1_sg1	GACAATACCGCATGTTAGTA
